"filename", "language", "CSS", "JavaScript", "HTML", "comment", "blank", "total"
"c:\Users\maxim\DA\el-pollo-loco\data-protection.html", "HTML", 0, 0, 296, 0, 10, 306
"c:\Users\maxim\DA\el-pollo-loco\imprint.html", "HTML", 0, 0, 95, 0, 16, 111
"c:\Users\maxim\DA\el-pollo-loco\index.html", "HTML", 0, 0, 117, 0, 42, 159
"c:\Users\maxim\DA\el-pollo-loco\js\script.js", "JavaScript", 0, 100, 0, 0, 44, 144
"c:\Users\maxim\DA\el-pollo-loco\levels\level1.js", "JavaScript", 0, 61, 0, 0, 6, 67
"c:\Users\maxim\DA\el-pollo-loco\models\background-object.class.js", "JavaScript", 0, 9, 0, 0, 1, 10
"c:\Users\maxim\DA\el-pollo-loco\models\bottle-bar.class.js", "JavaScript", 0, 16, 0, 0, 3, 19
"c:\Users\maxim\DA\el-pollo-loco\models\bottle.class.js", "JavaScript", 0, 23, 0, 0, 5, 28
"c:\Users\maxim\DA\el-pollo-loco\models\character.class.js", "JavaScript", 0, 193, 0, 0, 53, 246
"c:\Users\maxim\DA\el-pollo-loco\models\clouds.class.js", "JavaScript", 0, 17, 0, 0, 4, 21
"c:\Users\maxim\DA\el-pollo-loco\models\coin.class.js", "JavaScript", 0, 29, 0, 0, 7, 36
"c:\Users\maxim\DA\el-pollo-loco\models\coins-bar.class.js", "JavaScript", 0, 16, 0, 0, 3, 19
"c:\Users\maxim\DA\el-pollo-loco\models\collectable.class.js", "JavaScript", 0, 8, 0, 0, 4, 12
"c:\Users\maxim\DA\el-pollo-loco\models\drawable-object.class.js", "JavaScript", 0, 38, 0, 24, 10, 72
"c:\Users\maxim\DA\el-pollo-loco\models\endboss-bar.class.js", "JavaScript", 0, 16, 0, 0, 2, 18
"c:\Users\maxim\DA\el-pollo-loco\models\endboss.class.js", "JavaScript", 0, 190, 0, 0, 72, 262
"c:\Users\maxim\DA\el-pollo-loco\models\enemy-big.class.js", "JavaScript", 0, 29, 0, 0, 6, 35
"c:\Users\maxim\DA\el-pollo-loco\models\enemy-small.class.js", "JavaScript", 0, 22, 0, 0, 4, 26
"c:\Users\maxim\DA\el-pollo-loco\models\enemy.class.js", "JavaScript", 0, 27, 0, 0, 8, 35
"c:\Users\maxim\DA\el-pollo-loco\models\health-bar.class.js", "JavaScript", 0, 15, 0, 0, 2, 17
"c:\Users\maxim\DA\el-pollo-loco\models\keyboard.class.js", "JavaScript", 0, 6, 0, 0, 0, 6
"c:\Users\maxim\DA\el-pollo-loco\models\level.class.js", "JavaScript", 0, 18, 0, 0, 1, 19
"c:\Users\maxim\DA\el-pollo-loco\models\movable-object.class.js", "JavaScript", 0, 73, 0, 0, 22, 95
"c:\Users\maxim\DA\el-pollo-loco\models\status-bar.class.js", "JavaScript", 0, 21, 0, 0, 5, 26
"c:\Users\maxim\DA\el-pollo-loco\models\throwable-object.class.js", "JavaScript", 0, 93, 0, 0, 27, 120
"c:\Users\maxim\DA\el-pollo-loco\models\world.class.js", "JavaScript", 0, 165, 0, 0, 76, 241
"c:\Users\maxim\DA\el-pollo-loco\style.css", "CSS", 160, 0, 0, 18, 50, 228
"c:\Users\maxim\DA\el-pollo-loco\style2.css", "CSS", 94, 0, 0, 3, 40, 137
"Total", "-", 254, 1185, 508, 45, 523, 2515